3333333333
3611111153
3121221213
3111111113
3121221213
3121221213
3111111113
3121221213
3411111173
3333333333