3333333333
3111621113
3133213313
3131121313
3212331253
3421332123
3131211313
3133123313
3111271113
3333333333