3333333333
3611112153
3131131313
3213113113
3131221113
3111221313
3113113123
3131311313
3412111173
3333333333