3333333333
3111112113
3131131313
3213113113
3131221113
3111221313
3113113123
3131311313
3112111113
3333333333