3333333333
3112111113
3131311313
3113113123
3111221313
3131221113
3213113113
3131131313
3411112113
3333333333