3333333333
3111111113
3121221213
3111111113
3121221213
3121221213
3111111113
3121221213
3111111113
3333333333