3333333333
3111121113
3133213313
3131121313
3212331213
3121332123
3131211313
3133123313
3411211113
3333333333