3333333333
3111111113
3133113313
3131111313
3111331113
3111331113
3131111313
3133113313
3111111113
3333333333