3333333333
3612112153
3133333313
3231131123
3131221313
3131221313
3211311323
3133333313
3412112173
3333333333