3333333333
3112112113
3133333313
3231131123
3131221313
3131221313
3211311323
3133333313
3412112113
3333333333