3333333333
3111111113
3133333313
3131131113
3131111313
3131111313
3111311313
3133333313
3111111113
3333333333