3333333333
3112112113
3132222313
3223113223
3121221213
3121221213
3223113223
3132222313
3112112113
3333333333