3333333333
3612112153
3132222313
3223113223
3121221213
3121221213
3223113223
3132222313
3412112173
3333333333